15 16 1 6 3 1 6 2 1 6 1 8 6 2 18 15
1 6 2 6 1 14 6 1 4 6 1 1 6 1 6 2
1 17 15 5 15 15 5 15 15 5 15 15 5 15 19 1
2 9 0 6 1 7 6 1 3 6 1 8 6 4 1 0
1 1 1 6 10 1 6 1 2 6 1 1 6 1 11 2
15 15 15 5 15 15 5 15 15 5 15 15 5 15 15 15
1 2 1 6 4 2 6 1 12 6 1 3 6 2 10 1
3 1 11 6 1 14 6 1 1 6 7 1 6 1 2 1
1 1 2 6 2 1 6 0 1 6 1 1 6 1 1 1
1 18 15 5 15 15 5 15 15 5 15 15 5 15 16 9
9 6 2 6 1 1 6 10 1 6 14 2 6 14 6 1
15 19 1 6 12 2 6 1 1 6 1 1 6 1 17 15
